wwwwwwwwwwwwwwwwwww
wffb00000000000bffw
wfb0w0w0w0w0w0w0bfw
wb00000000000000wbw
w0w0w0w0w0w0w0w0w0w
w00000000000000000w
w0w0w0w0w0w0w0w0w0w
w00000000000000000w
w0w0w0w0w0w0w0w0w0w
w00000000000000000w
w0w0w0w0w0w0w0w0w0w
w0000000000000000bw
w0w0w0w0w0w0w0w0w0w
w00000000000000000w
w0w0w0w0w0w0w0w0w0w
wb000000000000000fw
wfb0w0w0w0w0w0w0ffw
wffb00000000000fffw
wwwwwwwwwwwwwwwwwww