wwwwwwwwwwwwwwwwwww
wffb00000000000fffw
wfb0w0w0w0w0w0w0ffw
wb0000000000d000wfw
w0w0w0w0w0w0w0w0w0w
w0000e000000000000w
w0w0w0w0w0w0w0w0w0w
w0000e000d0e000000w
w0w0w0w0w0w0w0w0w0w
w00000000000000000w
w0w0w0w0w0w0w0w0w0w
w000000e000000000bw
w0w0w0w0w0w0w0w0w0w
w00000000000000000w
w0w0w0w0w0w0w0w0w0w
wb000000000000000fw
wfb0w0w0w0w0w0w0ffw
wffb00000000000fffw
wwwwwwwwwwwwwwwwwww