wwwwwwwwwwwwwwwwwww
wff000000000000b00w
wf00w0w0w0w0w0w0b0w
wb00000000000000wbw
w0w0w0w0w0w0w0w0w0w
w00000000000000000w
w0w0w0w0w0w0w0w0w0w
w00000000000000000w
w0w0w0w0w0w0w0w0w0w
w00000000000000000w
w0w0w0w0w0w0w0w0w0w
w0000000000000000bw
w0w0w0w0w0w0w0w0w0w
w00000000000000000w
w0w0w0w0w0w0w0w0w0w
wb000000000000000fw
w0b0w0w0w0w0w0w0ffw
w00b00000000000fffw
wwwwwwwwwwwwwwwwwww