wwwwwwwwwwwwwwwww
wffb000000000bffw
wfb0w0w0w0w0w0bfw
wb0000000000000bw
w0w0w0w0w0w0w0w0w
w000000000000000w
w0w0w0w0w0w0w0w0w
w000000000000000w
w0w0w0w0w0w0w0w0w
w000000000000000w
w0w0w0w0w0w0w0w0w
w000000000000000w
w0w0w0w0w0w0w0w0w
wb0000000000000bw
wfb0w0w0w0w0w0bfw
wffb000000000bffw
wwwwwwwwwwwwwwwww