wwwwwwwwwwwwwwwwwww
wffb00000000000fffw
wfb0w0w0w0w0w0w0ffw
wb00000000000000wfw
w0w0w0w0w0w0w0w0w0w
w00000000000000000w
w0w0w0w0w0w0w0w0w0w
w00000000000000000w
w0w0w0w0w0w0w0w0w0w
w00000000000000000w
w0w0w0w0w0w0w0w0w0w
w0000000000000000bw
w0w0w0w0w0w0w0w0w0w
w00000000000000000w
w0w0w0w0w0w0w0w0w0w
w0000000000000000fw
wf00w0w0w0w0w0w0ffw
wff000000000000fffw
wwwwwwwwwwwwwwwwwww