wwwwwwwwwwwwwwwwwww
wffb0w000000000bffw
wfb00w0w0w0w0w00bfw
wb0w0w000w0w00w00bw
w000000w000w0w0w00w
w0ww0w0w0w000w0000w
w0000w0w0w0w0w0w00w
w00w0w00000w0w0000w
w000000w0w0w0w0w00w
w0w00w0w0w0w0w0000w
w0w00w0w0w00000w00w
w00w0w000w0w0w0000w
w00w000w0w0w0w0w00w
wb000w0w000w00w000w
w0000w0w0w0ww00000w
wb00000000000ww00bw
wfb000w0000w0000bfw
wffb00w000w0000bffw
wwwwwwwwwwwwwwwwwww