wwwwwwwwwwwwwwwww
wffb0w0000000bffw
wfb00w0w0w0w0wbfw
wb0w0w000w0w000bw
w000000w000w0000w
w00w0w0w0w000000w
w0000w0w0w0w0000w
w00w0w00000w0000w
w000000w0w0w0000w
w0w00w0w0w0w0000w
w0w00w0w0w000000w
w00w0w000w0w0000w
w00w000w0w0w0000w
wb000w0w000w000bw
wfb00w0w0w0w00bfw
wffb000000000bffw
wwwwwwwwwwwwwwwww