wwwwwwwwwwwwwwwwwww
wffb00000000000bffw
wfb000w0w0w00000bfw
wb00w0w0w0w0w0w00bw
w0w0w0w0w000w0w000w
w0w0w0w0w0w0w0w000w
w0w0w0w0w0w0000000w
w0w0w0000000w0w000w
w000w0w0w0w0w0w000w
w00000000000w0w000w
w000w00w0w00000000w
w000w00w0w0w0w0w0bw
w0w000000w0w000w00w
w0w00w0w0w00w00w00w
w0w00w0w0w00w0w000w
wb000w0w0w0w00w00bw
wfb00000000w00w0bfw
wffb00000000000bffw
wwwwwwwwwwwwwwwwwww